	 -> 　
===== Index 01 =========================
符义 -> 符文
Index[—－]Librorum[—－]Prohibitorum -> Index-Librorum-Prohibitorum
不块 -> 不愧
同袍 -> 同胞
栘动 -> 移动
喵了 -> 瞄了
很伯 -> 很怕
很伯 -> 很怕
栘 -> 移
御悮 -> 御坂
乎安 -> 平安
暍 -> 喝
失亿 -> 失忆
无力戚 -> 无力感
缣池 -> 鎌池
===== Index 02 =========================
舆(?!论) -> 与
学园都是 -> 学园都市
清敦 -> 清教
抛弃武 -> 抛弃式
自晤 -> 自语
姬神孙沙 -> 姬神秋沙
芳边 -> 旁边
刀刀(?!柄|尖|身) -> 刀刃
隆叫 -> 吼叫
奥尔欧斯 -> 奥雷欧斯
克提尔 -> 史提尔
健梗 -> 健康
寄连 -> 牵连
两干 -> 两千
亿圆 -> 亿元
万圆 -> 万元
千圆 -> 千元
百圆 -> 百元
十圆 -> 十元
一圆 -> 一元
方武 -> 方式
统奴 -> 统驭
史捉尔 -> 史提尔
午纪 -> 年纪
敦出 -> 救出
呵以 -> 可以
这此 -> 这些
曰正 -> 是
而日(?!本|复一日|日夜夜) -> 而且
斩学生 -> 新学生
史提雨 -> 史提尔
两干 -> 两千
傅来 -> 传来
宫炸 -> 爆炸
薄埂 -> 薄薄
===== Index 03 =========================
出土反 -> 出版
御土反 -> 御坂
而良 -> 而且
御扳 -> 御坂
御叛 -> 御坂
白己 -> 自己
建条 -> 建筑
吋 -> 寸
吋 -> 时
===== Index 04 =========================
—个 -> 一个
—刀 -> 一刀
触戚 -> 触感
===== Index 04 =========================
暗咲 -> 闇咲
===== Index 06 =========================
田然 -> 当然
配厶口你 -> 配合你
都市，D证明 -> 都市的证明
匿物 -> 怪物
千扰 -> 干扰
精链 -> 精炼
偶然问 -> 偶然间
亚雷斯塔。克劳利 -> 亚雷斯塔·克劳利
咸认为 -> 我认为
链金 -> 炼金
旦况气 -> 口冷气
名丰 -> 名字
任伺 -> 任何
协叻 -> 协助
柜当 -> 相当
怏 -> 快
柜比 -> 相比
口叩 -> 品
===== Index 07 =========================
魔导书 -> 魔道书
十宇凄教 -> 十字凄教
乡愿 -> 一厢情愿
奥索拉。阿奎纳 -> 奥索拉·阿奎纳
甚王 -> 甚至
抢定 -> 抢走
特别定(?!制) -> 特别是
呃……思…… -> 呃……嗯……
O·O -> 〇·〇
磨著 -> 磨着
St\.(?! ) -> St.
抽著 -> 抽着
司令宫 -> 司令官
嗯心 -> 恶心
敦义 -> 教义
规炬 -> 规矩
天乎 -> 天平
总西言之 -> 总而言之
赶陕 -> 赶快
钟甲 -> 铠甲
干变 -> 千变
闾 -> 间
===== Index 08 =========================
R•W[.•]S• -> R.W.S.
一OO三二 -> 一〇〇三二
二OOOO -> 二〇〇〇〇
二OOO一 -> 二〇〇〇一
虫隆 -> 轰隆
了商 -> 厂商
绿把 -> 你把
熟度 -> 热度
不层 -> 不屑
Schoo1 -> School
思心 -> 恶心
癌癌癌|痛癌癌|癌痛癌|癌癌痛|癌痛痛|痛癌痛|痛痛癌 -> 痛痛痛
计画 -> 计划
尤其足 ->尤其是
敦职 -> 教职
雨眼 -> 两眼
发送翠 -> 发送单
翠位 -> 单位
运人 -> 运入
逃疟 -> 逃走
心巾 -> 心中
十各 -> 十个
伯(?=打到) -> 怕
搂倒 -> 摔倒
浓榈 -> 浓稠
仃一道 -> 有一道
不傀 -> 不愧
恶~ -> 厄～
吼叫苦 -> 吼叫着
二〇〇〇— -> 二〇〇〇一
雨点(?=原则) -> 两点
逃定 -> 逃走
「门」字形 -> 「口」字形
伤门 -> 伤口
仲脚 -> 伸脚
戏谵 -> 戏谑
发牛 -> 发生
仿这种事 -> 做这种事
顺遂 -> 顺遂
二芳 -> 一旁
定得(?=太远) -> 走得
背超 -> 背起
不足(?=为了) -> 不是
便丽 -> 倩丽
八贴了 -> 只贴了
黑蜜掌 -> 黑蜜堂
一百停留 -> 一直停留
手电简 -> 手电筒
大戚不安 -> 大感不安
工了 -> 工厂
扪环 -> 扣环
韧春 -> 初春
看超来 -> 看起来
抽超 -> 抽起
拙在 -> 挂在
===== Index 09 =========================
萝拉[。.‧・]史都华 -> 萝拉·史都华
欧莉安娜[。.‧・]汤森 -> 欧莉安娜·汤森
丽多薇雅[。.‧・]罗伦婕蒂 -> 丽多薇雅·罗伦婕蒂
尼可拉[。.‧・]托尔斯泰 -> 尼可拉·托尔斯泰
奥雷欧斯[。.‧・]伊萨德 -> 奥雷欧斯·伊萨德
史提尔[。.‧・]马格努[斯靳] -> 史提尔·马格努斯
米夏[。.‧・]克洛伊洁芙 -> 米夏·克洛伊洁芙
查尔斯[。.‧・]康德查尔斯·康德
罗伦睫蒂|罗伦捷蒂 -> 罗伦婕蒂
奥索拉[。.‧・]阿奎纳 -> 奥索拉·阿奎纳
举超 -> 举起
魇法 -> 魔法
宇市 -> 宇宙
¨|i：|：： -> ！！
紧文褥节 -> 繁文缛节
一缯 -> 一缕
伦教 -> 伦敦
道地 -> 地道
镇定特定宗派 -> 确定特定宗派
郊果轻率 -> 如果轻率
得定啦 -> 得走啦
廿 -> 二十
发历成 -> 发展成
钉写 -> 有写
十条(?!人命|以上|腿) -> 上条
觉浔 -> 觉得
竟然此 -> 竟然比
你心(?!里|爱|中|软) -> 您
牵连人 -> 牵连入
察起 -> 塞起
英国清数 -> 英国清教
白并 -> 白井
自井 -> 白井
土却门 -> 土御门
山于 -> 由于
遗是 -> 还是
链制 -> 炼制
数廷 -> 教廷
===== Index 10 =========================
雪莉[。.‧・]克伦威尔 -> 雪莉·克伦威尔
西蒙[。.‧・]马古斯 -> 西蒙·马古斯
上归土|土归上|上归上 -> 土归土
有志一同 -> 有志一同
美钤 -> 美铃
㈠ -> ！？
隐喵 -> 隐瞒
定这里 -> 走这里
吏提尔 -> 史提尔
栢当 -> 相当
政变(?=[^\r\n]*身体) -> 改变
虫响 -> 轰响
烬管 -> 尽管
英国清软 -> 英国清教
标的物 -> 标志物
捏焖 -> 捏烂
吗9 -> 吗？
~ -> ～
连系 -> 联系
组织人(?=术式) -> 组织入
脚镰 -> 脚镣
嚼(?=！?？) -> 吗
翠字 -> 单字
门中(?!枢) -> 口中
而足 -> 而是
镇定 -> 锁定
十字凄数 -> 十字凄教
马格努靳 -> 马格努斯
踏人 -> 踏入
要帅 -> 耍帅
竞然 -> 竟然
===== Index 11 =========================
卷人 -> 卷入
王张 -> 主张
===== Index 12 =========================
俗他 -> 俗池
数师 -> 教师
===== Index 13 =========================
薏义 -> 意义
郁问 -> 郁闷
青蚌 -> 青蛙
傅进 -> 传进
医牛 -> 医生
流场 -> 流畅
不如是 -> 不知是
墓于 -> 基于
连作 -> 运作
土卸门 -> 土御门
撼绝 -> 灭绝
御板 -> 御坂
玫击 -> 攻击
平扰 -> 干扰
因禁 -> 囚禁
根末 -> 根本
章新 -> 重新
自贵 -> 自责
醋似 -> 酷似
门气 -> 口气
拙在 -> 扣在
一少 -> 一步
放卜 -> 放下
气血上街 -> 气血上涌
十万二千 -> 十万三千
格子 -> 桩子
磨灭之声 -> 魔灭之声
绦于 -> 终于
===== Index 14 =========================
縑池 -> 镰池
驱动错甲 -> 驱动铠甲
进出了 -> 迸出了
优先!! -> 优先——
韁绳 -> 缰绳
一一十 -> 二十
漏着 -> 扇着
局手 -> 高手
不威 -> 示威
异能主力 -> 异能之力
哑口怨言 -> 哑口無言
有此受 -> 有些受
卜条 -> 上条
一瞼 -> 一脸
十一一 -> 十二
楨 -> 枪
<字|〈字|く字 -> ㄑ字
镑甲 -> 铠甲
鍔甲 -> 铠甲
窜投 -> 空投
用不若 -> 用不着
一不 -> 示
===== Index 15 =========================
体品 -> 体晶
===== Index 16 =========================
保镳 -> 保镳
让步移动 -> 徒步移动
罗马正数 -> 罗马正教
上御门 -> 土御门
要([^，。？！?!…—]+?把戏) -> 耍$1
开欧 -> 开放
克洛伊洁英 -> 克洛伊洁芙
瓦碟 -> 瓦砾
人额 -> 人类
神手 -> 神子
十字凄敦 -> 十字凄教
雕刻船 -> 雕刻般
===== Index 17 =========================
齐字 -> 斋字
桥色 -> 橘色
裎 -> 里
姬种 -> 姬神
哑口无书 -> 哑口无言
眠神 -> 眼神
仲到 -> 伸到
常识而雷 -> 常识而言
乜 -> 也
===== Regios 01 ========================
确实足 -> 确实是
还足 -> 还是
菲一丽 -> 菲丽
佛梅特 -> 佛梅德
后侮 -> 后悔
崁入 -> 嵌入
===== Regios 03 ========================
一般教士科 -> 一般教养科
留冯 -> 雷冯
针研 -> 钻研
一迭 -> 一叠
日诵 -> 口诵
象样 -> 像样
电冯 -> 雷冯
===== Regios 04 ========================
授予目 -> 授予日
塞哈丁 -> 赛哈丁
戴克尔 -> 戴尔克
有人间 -> 有人问
妮尔姬 -> 娜尔姬
昨耳声 -> 咋舌声
妲娜洁娜 -> 妲尔洁娜
===== Regios 05t =======================
安得克 -> 安多克
===== Regios 06t =======================
能够奖 -> 能够将
请报(?!告) -> 情报
===== Regios 05 ========================
一般教音科 -> 一般教养科
===== Regios 06 ========================
果然足 -> 果然是
可亚(?!里亚) -> 可恶
介缙 -> 介绍
圣于 -> 至于
姐尔洁娜 -> 妲尔洁娜
===== Regios 08tr ======================
这中 -> 这种
===== Regios 09 ========================
开殷 -> 开启
门屝 -> 门扉
遗不 -> 还不
金属扳 -> 金属板
提桉 -> 提案
彷造 -> 仿造
雨人 -> 两人
这捏面 -> 这里面
疲劳戚 -> 疲劳感
没育 -> 没有
赛啥丁 -> 赛哈丁
出雷反驳 -> 出言反驳
雷吉奥斯 -> 雷吉欧斯
炼金纲 -> 炼金钢
坦尔洁娜 -> 妲尔洁娜
锁炼 -> 锁链
干辛万苦 -> 千辛万苦
结东 -> 结束
奉不 -> 表示
逞局 -> 提高
一污 -> 污
受弱 -> 变弱
如央 -> 如果
昼面 -> 画面
动柞 -> 动作
着不见 -> 看不见
===== Regios 11tr ======================
讯问 -> 询问
寻问 -> 询问
打倒目的 -> 达到目的
战了起来 -> 站了起来
不想样 -> 不像样
所生无几 -> 所剩无几
===== Rental Magica 01 =================
解僱 -> 解雇
溷 -> 混
煳 -> 糊
馀 -> 余
勐 -> 猛
千涉 -> 干涉
===== Rental Magica 02 =================
不可恩议 -> 不可思议
===== Rental Magica 03 =================
没行 -> 没有
号泛样这样
後后
（协会） -> 〈协会〉
（盖提亚） -> 〈盖提亚〉
占老 -> 古老
===== Maho_Senshi_Riui =================
日是 -> 是
===== Dragon_Crisis 03 =================
并不住 -> 并不佳
===== Tasogareiro_no_Utatsukai 01 ======
晰蜴 -> 蜥蜴
闇 -> 暗
===== God's_Notepad 01 =================
不千 -> 不干
===== God's_Notepad 02 =================
海崃 -> 海峽
楞 -> 愣
瓦愣 -> 瓦楞
门炼 -> 门链
===== God's_Notepad 03 =================
COLORADO　BULLDOG -> COLORADO BULLDOG
===== God's_Notepad 04 =================
欲言又什 -> 欲言又止
垃阪 -> 垃圾
害伯 -> 害怕
===== Venus_to_Mamoru 02 ===============
层开 -> 展开
===== Shakugan_no_Shana 01 =============
恶耗 -> 噩耗
===== GOSICK_01 ========================
衬里 -> 村里
雨个 -> 两个
翰赢 -> 输赢
见曝 -> 见晓
===== GOSICK_0５ ========================
別 -> 别
===== Kampfer_01 =======================
～点 -> 一点
===== Baka_01 ==========================
我样 -> 我们
试如战争 -> 试召战争
都育者 -> 教育者
输组 -> 输给
学样 -> 学校
让住 -> 记住
欲能 -> 却能
长到 -> 找到
某外 -> 某处
聊想 -> 联想
些处 -> 此处
忧心仲仲 -> 忧心忡忡
籍此 -> 借此
些时(?!间) -> 此时
===== Baka_03.5 ========================
NOl -> NO1
丰上 -> 手上
拥行 -> 排行
二疋 -> 一定
===== Baka_04 ==========================
总西言之 -> 总而言之
寒唁一 -> 寒暄
翠百一 -> 发言
正武 -> 正式
方武 -> 方式
乍休 -> 午休
第一一次 -> 第二次
面百 -> 而言
西百 -> 而言
面言 -> 而言
二口 -> 一台
入木一二分 -> 入木三分
未竞 -> 未竟
嘿心 -> 恶心
想象 -> 想像
娟一率 -> 坦率
模武 -> 模式
===== 9S ===============================
可莉儿 -> 可丽儿
蔌原 -> 荻原
萩原 -> 荻原
扳上 -> 坂上
真日 -> 真目
===== 9S_01 ============================
脸刃 -> 剑刃
于枪(?!口) -> 手枪
哑门无言 -> 哑口无言
===== 9S_02 ============================
跔 -> 跑
匣况气 -> 口冷气
暍 -> 喝
===== 9S_03 ============================
洗链 -> 洗练
评占 -> 评估
白己 -> 自己
白觉 -> 自觉
白由 -> 自由
亲感 -> 亲戚
差丽 -> 美丽
获原 -> 荻原
去仿(?!佛) -> 去做
要狠(?!狠) -> 耍狠
佣懒 -> 慵懒
===== 9S_06 ============================
王少 -> 至少
上兵(?!器|营) -> 士兵
茎丽 -> 华丽
怱然 -> 忽然
伯麻烦 -> 怕麻烦
直一 -> 真
直二 -> 真一
直丁． -> 真！
直丫 -> 真
晅种 -> 这种
逗种 -> 这种
采测 -> 探测
直薏 -> 真意
被要(?!求) -> 被耍
二正 -> 一定
王爱 -> 至爱
不相千 -> 不相干
创遥 -> 创造
===== 9S_08 ============================
咨一料 -> 资料
音一料 -> 资料
翌一 -> 翼
([^问议话])题不 -> $1显示
有自的 -> 有目的
二定 -> 一一定
同诟 -> 同调
育用 -> 实用
傅出 -> 传出
([^问话议])题不 -> $1显示
田i议 -> 思意
优越戚 -> 优越感
大宫 -> 大官
晶味 -> 品味
画言 -> 而言
断断绩续 -> 断断续续
断断续绩 -> 断断续续
装饰晶 -> 装饰品
缺陷晶 -> 缺陷品
物晶 -> 物品
作晶 -> 作品
===== 9S_09 ============================
仟何 -> 任何
甚圣 -> 甚至
栘 -> 移
===== 9S_10 ============================
===== Daimao_01 ========================
碎层 -> 碎屑
魔术帅 -> 魔术师
炬阵 -> 矩阵
圣今 -> 至今
骑七团 -> 骑士团
骑上专用 -> 骑士专用
定出 -> 走出
锻链 -> 锻炼


===== 繁体 =============================
([^原执显])著(?!名|称|作) -> $1着
显着 -> 显著
着作(?!为|战|业|用力) -> 著作
着名(?!字|叫|单|牌|为) -> 著名
着有(?!种|如|利) -> 著有
原着 -> 原著
执着 -> 执著
争执著 -> 争执着
着称 -> 著称
显着 -> 显著

姊 -> 姐
拚 -> 拼
没辄 -> 没辙
辄 -> 辙
动辙 -> 动辄
义大利 -> 意大利
义式 -> 意式
追根究柢 -> 追根究底
萤光灯 -> 荧光灯
萤幕 -> 荧幕
佇立 -> 伫立
企画 -> 企划
策画 -> 策划
菸 -> 烟
蒐 -> 搜
乾(?!坤) -> 干
干坤 -> 乾坤
徵 -> 征
後 -> 后
終 -> 终
座标 -> 坐标
柜枱 -> 柜台
杓 -> 勺
澹 -> 淡
黏->粘
粘膜 -> 黏膜
黏贴 -> 粘贴
妳 -> 你
牠 -> 它
隻 -> 只
鬆 -> 松
複 -> 复
閒 -> 闲
吶 -> 呐
矇 -> 蒙
採 -> 采
佔 -> 占
於 -> 于
鑰 -> 钥
躂 -> 跶
擧 -> 举
钜 -> 巨
鎚 -> 锤
讬 -> 托
唸 -> 念
盃 -> 杯
樁 -> 桩
繫 -> 系
揹 -> 背
燄 -> 焰
鏘 -> 锵
鍊金 -> 炼金
註 -> 注
僕 -> 仆
========================================

http：// -> http://

裹(?!足|住|着|在|上|里|进) -> 里
([^青翡])翠 -> $1单


([^头腹胸腰背])部被 -> $1都被
什么部做 -> 什么都做
([^底后内外压腰上胸根头背干腿本分面])部是 -> $1都是

(全|大半|里面)部是 -> $1都是

(全|大半)都是 -> $1部是
中心都 -> 中心部
后半都 -> 后半部


([^书提包钱背腰])包里 -> $1包裹


([「『（“，。…—　])[恩思](?=[，。？！…—～」）”]) -> $1嗯
\n[恩思] -> 嗯
[恩思][恩思] -> 嗯嗯
[恩思]哼 -> 嗯哼
[恩思]唔 -> 嗯唔
唔[恩思] -> 唔嗯
[恩思]啊啊
[恩思]哪 -> 嗯哪
[恩思][恩思][恩思] -> 嗯嗯嗯


％ -> %%


奸 -> 好
奸像 -> 好像
好细 -> 奸细


国藉 -> 国籍
英藉 -> 英籍
书藉 -> 书籍

([^狼慰])藉 -> $1借
慰借 -> 慰藉
狼借 -> 狼藉


拾起头 -> 抬起头
拾起 -> 抬起
抬起(?!头|脸|脚) -> 拾起

([^实])践(?!踏) -> $1跩

义(?=是|出现|消失) -> 又

([^意主名教定正涵大道思奥讲忠寡含仁结侠要广同负守])义(?!务|大利|中学|工|无反顾|理|体|兄|弟|气|的距离|肢|足|贼) -> $1又


—([缕切边脸惊跳语眼座场般]) -> 一$1

([^—])—(?!—) -> $1—


()(房|楼梯|淋浴|淋浴|洗手|脱衣)问 -> $2间
人问(?!她|他|起|了|到|出|个|津|题) -> 人间
那问(店|鬼屋) -> 那间$1
这问(?!题) -> 这间
那问(?!题) -> 那间
卒问 -> 空间
一问 -> 一间
某问 -> 某间
时问 -> 时间
瞬问 -> 瞬间
整问 -> 整间
之问 -> 之间
期问 -> 期间
腰问 -> 腰间
空问 -> 空间
楼问 -> 楼间
其问 -> 其间
期问 -> 期间
事物问 -> 事物间
家族问 -> 家族间
刹那问 -> 刹那间
言语问 -> 言语间
忽然问 -> 忽然间
分子问 -> 分子间
同学问 -> 同学间
一线问 -> 一线间
忽然问 -> 忽然间
波浪问 -> 波浪间
转眼问 -> 转眼间
两者问 -> 两者间
无意问 -> 无意间
国际问 -> 国际间
物体问 -> 物体间
树林问 -> 树林间
突然问 -> 突然间
缝隙问 -> 缝隙间
问不容发 -> 间不容发
不自觉问 -> 不自觉间
不知不觉问 -> 不知不觉间
举手投足问 -> 举手投足间

问距 -> 间距
问断 -> 间断
问接 -> 间接

充耳不问 -> 充耳不闻

([^一疑询质请发追被访再提想自会没询慰审过逼拷你我所查先要问敢故用])问(?!问|出|了|道|过|起|到|题|这个问题|谁|句|您|你|妳|我|他|她|自己|其他|不出口|候|又问不出口|都不问|询|号|答|完|那么多|世|话|心无愧|个问题|个清楚|清楚|下去|教堂) -> $1间

一间(?!间|教室|病房|实验室|大学|房间|牢房|民宅|教堂|房|学院|图书馆|面包店|食堂|高中|餐厅|学校|医院|公共澡堂|屋里) -> 一问
有间(?!暇) -> 有问
还间 -> 还问
逼间 -> 逼问
开口间 -> 开口问
如此间道 -> 如此问道

([^风一房空时瞬之期中行人然腰夜其世隔晨午凡衣民眼月课单楼指谷市整年眉浴林无坊离山相居隙觉跨])间(?!谍|断|学校|高中|新房子|食堂|餐厅|店|运动用品店|电动游乐场|教室|隔|室内|便利商|淋浴室|接|咖啡厅|隙|房间|公司|医院|神社|宿舍|房子|道场|学园|米店|距|缝|鬼屋|不容发|水疗休闲馆|保健室|地下室|修养房|密室|纪念馆|研究所|研究室|仓库|大学|国小|图书馆|百货公司|补习班|浴室|暇|感化院) -> $1问

时闻 -> 时间


足(?=体育课|个|不是|我) -> 是
就足(?!够|以|足) -> 就是
会足 -> 会是
都足 -> 都是
光足 -> 光是
才足 -> 才是
我足 -> 我是
说足 -> 说是
真足 -> 真是
这次足 -> 这次是
简直足 -> 简直是
可不足 -> 可不是
可能足 -> 可能是
成分足 -> 成分是
牵手足 -> 牵手是
问题足 -> 问题是
今天足 -> 今天是
其实足 -> 其实是
手段足 -> 手段是
到底足 -> 到底是
说来足 -> 说来是
似乎足 -> 似乎是
当然不足 -> 当然不是
足来 -> 是来
足指 -> 是指
足要 -> 是要
足谁 -> 是谁
足比较 -> 是比较
足表示 -> 是表示
足这么 -> 是这么
不足个 -> 不是个
不足这么 -> 不是这么
如何足好 -> 如何是好

([^立十吃满卯跨充裹远补饱手论鼓复前失自双足投蓄凑])足(?!以|球|够|道|踝|浴|足|音|底|部|下|边|尖|技|迹|不出户|的情况|的事实|为奇|蹈|惜|足) -> $1是

是以用来 -> 足以用来

是以(?!前|后) -> 足以

卒 -> 空


梢 -> 稍

梢为 -> 稍为
梢远 -> 稍远
梢显 -> 稍显
梢作 -> 稍作
梢有 -> 稍有
梢微 -> 梢微

发稍(?!微) -> 发梢


([^赋给施寄赐授赠不])予(?!理会|以) -> $1手


下([知觉足愧想]|公平)(?!工夫) -> 不$1


([^庭马])上作(?!证|战|为|家|出|下|答) -> $1工作


一股(?!脑|劲|血|气|火|热|刭|怒|郁闷|恐惧|异臭|力量|憎恨|恶寒|寒冷|不安|负面|疑问|重压|重担|重量|焦躁|爆炸|巨大|意识|视线|期待|冲击|强悍|阴影|波浪|深邃|没落|愤怒|红晕|体温|静电|坚强|甜蜜|白烟|无奈|吸引力|无名火|新势力|不耐烦|不对劲|[^，。？！][气痛意味动风香伤觉流寞劲栗]|[^，。？！]{2}(味|感|力|压力|香味|气息|氛围|气氛|之气|怒意)|[^，。？！]{1,10}的) -> 一般

一股(的|(伦敦)?市警) -> 一般$1


○|○ -> 〇
O(?! ?[a-zA-Z]) -> 〇



目的的 -> 目的地



「如往常 -> 一如往常


〡 -> —


!! -> ——


……， -> ……
……。 -> ……


＿ -> _


(    |　　|\r\n)丁([^\r\n]+」) -> $1「$2
(    |　　|\r\n)二([定次架])([^\r\n]+」) -> $1「一$2$3
(    |　　|\r\n)=[坦迫]([^\r\n]+」) -> $1「这$2

(    |　　|\r\n)气([^\r\n]+』) -> $1『$2

(『[^\r\n]+)二(\r\n) -> $1』
(『[^\r\n]+)乙(\r\n) ->$1 』
(『[^\r\n]+)L(\r\n) ->$1 』
(「[^\r\n]+)一(\r\n) ->$1 」
(「[^\r\n]+)l(\r\n) -> $1」
